Año,Trimestre,Provincia,ADSL,Cablemodem,Fibra Óptica,Wireless,Otros,Total,Trimestre_Label
2024,2,BUENOS AIRES,214055,2722466,1849476,138638,64745,4989380,Q2
2024,2,CABA,54102,1144781,230402,4493,29821,1463599,Q2
2024,2,CATAMARCA,4951,10303,58355,1384,81,75074,Q2
2024,2,CHACO,9448,57935,68944,8407,2358,147092,Q2
2024,2,CHUBUT,25955,80704,26516,31118,9930,174223,Q2
2024,2,CÓRDOBA,93483,443091,477504,62162,9534,1085774,Q2
2024,2,CORRIENTES,14849,86226,39792,10295,5313,156475,Q2
2024,2,ENTRE RÍOS,31335,158918,68540,23954,11564,294311,Q2
2024,2,FORMOSA,8488,18768,18977,16430,287,62950,Q2
2024,2,JUJUY,9509,51361,53492,4106,1216,119684,Q2
2024,2,LA PAMPA,6778,58647,37226,19510,1102,123263,Q2
2024,2,LA RIOJA,2230,55531,23294,6396,30,87481,Q2
2024,2,MENDOZA,17671,66636,188815,27606,925,301653,Q2
2024,2,MISIONES,20868,76427,87389,14968,6902,206554,Q2
2024,2,NEUQUÉN,23553,72698,41784,24549,958,163542,Q2
2024,2,RÍO NEGRO,20771,49722,67636,18083,15829,172041,Q2
2024,2,SALTA,19831,98511,64689,11807,6503,201341,Q2
2024,2,SAN JUAN,12669,16978,45792,23594,6957,105990,Q2
2024,2,SAN LUIS,4038,40063,34255,78954,299,157609,Q2
2024,2,SANTA CRUZ,7768,14134,49545,11353,661,83461,Q2
2024,2,SANTA FE,88486,394939,390090,44286,13172,930973,Q2
2024,2,SANTIAGO DEL ESTERO,5328,80000,30008,7058,2920,125314,Q2
2024,2,TIERRA DEL FUEGO,9357,47859,3684,177,332,61409,Q2
2024,2,TUCUMÁN,27968,20806,213753,3869,518,266914,Q2
2024,1,CABA,70108,1177475,203756,4493,48879,1504711,Q1
2024,1,CATAMARCA,5901,11025,56542,1384,81,74933,Q1
2024,1,CHACO,11343,58929,64463,8404,12404,155543,Q1
2024,1,CHUBUT,26306,77217,26356,30867,9930,170676,Q1
2024,1,CÓRDOBA,102812,449784,458985,61121,9497,1082199,Q1
2024,1,CORRIENTES,18390,85595,38268,10409,5232,157894,Q1
2024,1,ENTRE RÍOS,36574,158283,66180,23950,11565,296552,Q1
2024,1,FORMOSA,9147,18631,17908,16851,181,62718,Q1
2024,1,JUJUY,10554,51093,51084,4106,1216,118053,Q1
2024,1,LA PAMPA,6844,59008,35556,19681,1106,122195,Q1
2024,1,LA RIOJA,2827,55443,23086,6396,30,87782,Q1
2024,1,MENDOZA,17674,70932,185460,27606,925,302597,Q1
2024,1,MISIONES,23217,77561,81498,13378,6902,202556,Q1
2024,1,NEUQUÉN,24076,73298,41577,24387,908,164246,Q1
2024,1,RÍO NEGRO,20841,49727,66889,17733,15829,171019,Q1
2024,1,SALTA,23858,99150,61543,11807,6503,202861,Q1
2024,1,SAN JUAN,12669,18543,44904,23594,6956,106666,Q1
2024,1,SAN LUIS,4038,41260,31539,78954,299,156090,Q1
2024,1,SANTA CRUZ,7768,14435,49545,7799,661,80208,Q1
2024,1,SANTA FE,86548,399817,374288,44162,13773,918588,Q1
2024,1,SANTIAGO DEL ESTERO,6644,80722,27018,7058,2920,124362,Q1
2024,1,TIERRA DEL FUEGO,9357,48005,3684,177,332,61555,Q1
2024,1,TUCUMÁN,33682,20361,205959,4075,518,264595,Q1
2023,4,BUENOS AIRES,223391,2797700,1784593,137993,67943,5011620,Q4
2023,4,CABA,58700,1198835,182520,4492,29820,1474367,Q4
2023,4,CATAMARCA,6669,11016,55437,1384,81,74587,Q4
2023,4,CHACO,14000,60277,62301,8404,2404,147386,Q4
2023,4,CHUBUT,26306,77217,26174,30543,9930,170170,Q4
2023,4,CÓRDOBA,115662,452380,440536,61862,8862,1079302,Q4
2023,4,CORRIENTES,21769,86102,35968,10402,5231,159472,Q4
2023,4,ENTRE RÍOS,41794,159575,61667,24036,11565,298637,Q4
2023,4,FORMOSA,10252,18325,16179,17061,185,62002,Q4
2023,4,JUJUY,11669,51083,49947,4105,1216,118020,Q4
2023,4,LA PAMPA,6844,59063,34331,19982,1106,121326,Q4
2023,4,LA RIOJA,3296,55441,22559,6395,30,87721,Q4
2023,4,MENDOZA,17676,70920,182220,27609,926,299351,Q4
2023,4,MISIONES,25840,79000,75382,12928,7183,200333,Q4
2023,4,NEUQUÉN,24122,73784,41583,24390,748,164627,Q4
2023,4,RÍO NEGRO,21192,49789,64323,17284,15829,168417,Q4
2023,4,SALTA,26765,98853,60800,11806,6508,204732,Q4
2023,4,SAN JUAN,12669,18543,42691,22351,6956,103210,Q4
2023,4,SAN LUIS,4037,41260,30135,78954,299,154685,Q4
2023,4,SANTA CRUZ,7768,15669,55246,7687,661,87031,Q4
2023,4,SANTA FE,97004,398670,355762,44521,13544,909501,Q4
2023,4,SANTIAGO DEL ESTERO,8290,80692,24271,7057,2920,123230,Q4
2023,4,TIERRA DEL FUEGO,9357,48071,3682,157,332,61599,Q4
2023,4,TUCUMÁN,41318,20267,199876,4357,517,266335,Q4
2023,3,BUENOS AIRES,237705,2784175,1740239,137921,68197,4968237,Q3
2023,3,CABA,60765,1205339,167428,4629,29823,1467984,Q3
2023,3,CATAMARCA,7164,11066,54650,1384,91,74355,Q3
2023,3,CHACO,16420,60058,54993,8267,2408,142146,Q3
2023,3,CHUBUT,26352,75460,25827,30521,9908,168068,Q3
2023,3,CÓRDOBA,125050,453994,417338,62514,10438,1069334,Q3
2023,3,CORRIENTES,24253,83897,36032,10407,5240,159829,Q3
2023,3,ENTRE RÍOS,45384,157464,54794,24481,11170,293293,Q3
2023,3,FORMOSA,11230,18053,14904,16899,228,61314,Q3
2023,3,JUJUY,12627,51082,48350,4067,1251,117377,Q3
2023,3,LA PAMPA,6844,59063,32891,20014,1109,119921,Q3
2023,3,LA RIOJA,3726,55494,22054,6395,32,87701,Q3
2023,3,MENDOZA,17677,73066,178719,27609,951,298022,Q3
2023,3,MISIONES,27934,79087,70003,12928,7183,197135,Q3
2023,3,NEUQUÉN,24527,73329,39243,24085,3089,164273,Q3
2023,3,RÍO NEGRO,22422,50429,56668,16864,17102,163485,Q3
2023,3,SALTA,29113,98324,59914,12337,6545,206233,Q3
2023,3,SAN JUAN,12669,19376,42383,22317,6985,103730,Q3
2023,3,SAN LUIS,4037,41624,24525,78431,299,148916,Q3
2023,3,SANTA CRUZ,8376,23931,11270,3660,750,47987,Q3
2023,3,SANTA FE,108503,397854,336013,44545,13437,900352,Q3
2023,3,SANTIAGO DEL ESTERO,9412,80919,21745,6916,2936,121928,Q3
2023,3,TIERRA DEL FUEGO,9357,45203,3682,157,332,58731,Q3
2023,3,TUCUMÁN,46348,20545,195053,4088,523,266557,Q3
2023,2,BUENOS AIRES,265537,2766463,1645945,138405,69138,4885488,Q2
2023,2,CABA,68348,1218631,136295,4504,29900,1457678,Q2
2023,2,CATAMARCA,7637,10700,53177,1384,92,72990,Q2
2023,2,CHACO,19115,59944,51955,8267,2574,141855,Q2
2023,2,CHUBUT,33702,73689,16111,30521,9938,163961,Q2
2023,2,CÓRDOBA,129303,453924,411703,62391,10430,1067751,Q2
2023,2,CORRIENTES,26821,82977,32834,10407,5255,158294,Q2
2023,2,ENTRE RÍOS,46503,142562,49251,24461,11170,273947,Q2
2023,2,FORMOSA,11934,17678,13698,16813,227,60350,Q2
2023,2,JUJUY,13749,51082,47289,4067,1255,117442,Q2
2023,2,LA PAMPA,7254,59101,31449,19993,1113,118910,Q2
2023,2,LA RIOJA,4152,55148,21245,6395,32,86972,Q2
2023,2,MENDOZA,25299,71931,171857,27609,980,297676,Q2
2023,2,MISIONES,28897,82058,64406,12927,7183,195471,Q2
2023,2,NEUQUÉN,26379,73040,35171,24046,3110,161746,Q2
2023,2,RÍO NEGRO,26390,49684,53325,16864,17116,163379,Q2
2023,2,SALTA,30666,97501,58275,12337,6549,205328,Q2
2023,2,SAN JUAN,21483,20200,25217,23545,7004,97449,Q2
2023,2,SAN LUIS,4937,41949,15595,77960,307,140748,Q2
2023,2,SANTA CRUZ,9019,23896,11269,3660,758,48602,Q2
2023,2,SANTA FE,126344,399669,311166,44134,14501,895814,Q2
2023,2,SANTIAGO DEL ESTERO,10629,80086,17244,6916,2934,117809,Q2
2023,2,TIERRA DEL FUEGO,12392,45224,525,157,337,58635,Q2
2023,2,TUCUMÁN,50019,20012,188986,4060,525,263602,Q2
2023,1,BUENOS AIRES,304583,2761043,1551074,132458,71770,4820928,Q1
2023,1,CABA,132149,1223930,156222,4605,31823,1548729,Q1
2023,1,CATAMARCA,6980,10655,50230,1384,2243,71492,Q1
2023,1,CHACO,21243,60727,49756,8142,2574,142442,Q1
2023,1,CHUBUT,45448,73525,9815,30521,10744,170053,Q1
2023,1,CÓRDOBA,136976,455139,386297,61066,10494,1049972,Q1
2023,1,CORRIENTES,29577,81116,30016,11071,5240,157020,Q1
2023,1,ENTRE RÍOS,51084,141699,44508,26415,11172,274878,Q1
2023,1,FORMOSA,12502,17421,13345,17490,227,60985,Q1
2023,1,JUJUY,15306,51082,46271,4067,1255,117981,Q1
2023,1,LA PAMPA,7049,59944,28126,20103,1282,116504,Q1
2023,1,LA RIOJA,4652,54604,20722,6395,32,86405,Q1
2023,1,MENDOZA,37646,73678,152534,27592,1569,293019,Q1
2023,1,MISIONES,30455,82834,56619,12896,7881,190685,Q1
2023,1,NEUQUÉN,28030,72639,32296,23937,3510,160412,Q1
2023,1,RÍO NEGRO,33604,49128,45329,16857,19413,164331,Q1
2023,1,SALTA,33427,96922,56259,12269,6549,205426,Q1
2023,1,SAN JUAN,38568,21215,12798,21912,7274,101767,Q1
2023,1,SAN LUIS,6283,42789,6952,78954,485,135463,Q1
2023,1,SANTA CRUZ,9702,23839,12217,3660,943,50361,Q1
2023,1,SANTA FE,138935,405618,283988,43487,14246,886274,Q1
2023,1,SANTIAGO DEL ESTERO,11642,80407,16656,6916,2934,118555,Q1
2023,1,TIERRA DEL FUEGO,12754,43146,405,157,651,57113,Q1
2023,1,TUCUMÁN,55822,19482,180976,4293,527,261100,Q1
2022,4,BUENOS AIRES,325908,2767247,1499149,129910,72451,4794665,Q4
2022,4,CABA,138753,1238196,138548,4603,31826,1551926,Q4
2022,4,CATAMARCA,8952,10998,47337,1379,2243,70909,Q4
2022,4,CHACO,24582,61265,47285,7957,2574,143663,Q4
2022,4,CHUBUT,45450,73923,9815,30721,8850,168759,Q4
2022,4,CÓRDOBA,152265,456947,367393,61631,11424,1049660,Q4
2022,4,CORRIENTES,34038,80283,26752,9082,5298,155453,Q4
2022,4,ENTRE RÍOS,55507,135746,40798,26414,12509,270974,Q4
2022,4,FORMOSA,13735,17068,13118,17692,227,61840,Q4
2022,4,JUJUY,17880,52390,42626,4067,1255,118218,Q4
2022,4,LA PAMPA,7785,60566,24552,19995,1266,114164,Q4
2022,4,LA RIOJA,6120,54387,19328,6395,32,86262,Q4
2022,4,MENDOZA,37655,77814,147080,27607,1948,292104,Q4
2022,4,MISIONES,33204,87202,46885,11075,7903,186269,Q4
2022,4,NEUQUÉN,28609,72679,31567,23815,3510,160180,Q4
2022,4,RÍO NEGRO,34043,48401,43958,16277,19413,162092,Q4
2022,4,SALTA,36939,97023,53470,11884,6544,205860,Q4
2022,4,SAN JUAN,38570,22913,12491,21912,7940,103826,Q4
2022,4,SAN LUIS,6283,43460,3409,81557,511,135220,Q4
2022,4,SANTA CRUZ,9702,23876,12217,3746,662,50203,Q4
2022,4,SANTA FE,163621,412157,248558,44113,19242,887691,Q4
2022,4,SANTIAGO DEL ESTERO,13577,80955,15117,6911,2934,119494,Q4
2022,4,TIERRA DEL FUEGO,12754,41293,405,157,651,55260,Q4
2022,4,TUCUMÁN,69441,20668,168717,4069,527,263422,Q4
2022,3,BUENOS AIRES,339648,2748325,1436433,126846,70416,4721668,Q3
2022,3,CABA,140791,1240125,129218,5758,31787,1547679,Q3
2022,3,CATAMARCA,10010,10495,46224,1329,2235,70293,Q3
2022,3,CHACO,27164,61800,44645,8178,2359,144146,Q3
2022,3,CHUBUT,45377,72212,9574,29784,8831,165778,Q3
2022,3,CÓRDOBA,163770,465461,338570,61070,9797,1038668,Q3
2022,3,CORRIENTES,36508,77140,18619,7256,5323,144846,Q3
2022,3,ENTRE RÍOS,60345,132952,36971,26098,12593,268959,Q3
2022,3,FORMOSA,14470,25880,11041,16935,212,68538,Q3
2022,3,JUJUY,19257,52978,40172,4033,2383,118823,Q3
2022,3,LA PAMPA,7796,60078,23551,20216,4451,116092,Q3
2022,3,LA RIOJA,6842,53899,19697,6395,31,86864,Q3
2022,3,MENDOZA,37659,78858,142615,27625,2766,289523,Q3
2022,3,MISIONES,35513,88902,39046,11074,7622,182157,Q3
2022,3,NEUQUÉN,29352,75815,29396,27482,1116,163161,Q3
2022,3,RÍO NEGRO,35552,48260,41017,16760,18969,160558,Q3
2022,3,SALTA,40006,96984,50254,10082,7215,204541,Q3
2022,3,SAN JUAN,38570,22723,12328,21860,7918,103399,Q3
2022,3,SAN LUIS,6860,29363,248,70614,14985,122070,Q3
2022,3,SANTA CRUZ,10170,24047,10815,3896,582,49510,Q3
2022,3,SANTA FE,183740,426255,215189,43079,19547,887810,Q3
2022,3,SANTIAGO DEL ESTERO,15385,80937,13170,6618,2922,119032,Q3
2022,3,TIERRA DEL FUEGO,12754,39963,403,125,651,53896,Q3
2022,3,TUCUMÁN,77738,18518,162345,3997,519,263117,Q3
2022,2,BUENOS AIRES,350652,2719613,1399043,126847,71028,4667183,Q2
2022,2,CABA,145491,1232226,121506,5757,31791,1536771,Q2
2022,2,CATAMARCA,11928,9430,42087,1329,2234,67008,Q2
2022,2,CHACO,29552,61284,42194,8178,2356,143564,Q2
2022,2,CHUBUT,45377,69242,9574,29784,8828,162805,Q2
2022,2,CÓRDOBA,179181,467595,308895,61107,9657,1026435,Q2
2022,2,CORRIENTES,38468,75769,18181,7256,5323,144997,Q2
2022,2,ENTRE RÍOS,63794,131029,35839,26098,12592,269352,Q2
2022,2,FORMOSA,15397,25487,9875,16910,212,67881,Q2
2022,2,JUJUY,20303,54495,34184,3955,2377,115314,Q2
2022,2,LA PAMPA,7796,59273,22994,20200,1264,111527,Q2
2022,2,LA RIOJA,7759,52656,19189,6395,31,86030,Q2
2022,2,MENDOZA,37663,77504,135504,26964,1927,279562,Q2
2022,2,MISIONES,37208,89260,33649,11074,7622,178813,Q2
2022,2,NEUQUÉN,29749,74905,28824,27371,1119,161968,Q2
2022,2,RÍO NEGRO,36050,47040,40946,16760,18968,159764,Q2
2022,2,SALTA,42665,96178,47076,10068,7190,203177,Q2
2022,2,SAN JUAN,38570,19734,12328,21859,7916,100407,Q2
2022,2,SAN LUIS,6860,29034,248,70614,14985,121741,Q2
2022,2,SANTA CRUZ,10170,23725,10815,3896,579,49185,Q2
2022,2,SANTA FE,198492,428233,189503,43081,19550,878859,Q2
2022,2,SANTIAGO DEL ESTERO,16561,80338,11605,6618,2922,118044,Q2
2022,2,TIERRA DEL FUEGO,12754,39837,403,125,651,53770,Q2
2022,2,TUCUMÁN,85893,15327,148823,3997,487,254527,Q2
2022,1,BUENOS AIRES,392045,2728865,1242121,125521,66872,4555424,Q1
2022,1,CABA,102290,1217225,62308,5784,29934,1417541,Q1
2022,1,CATAMARCA,14181,15517,29118,1328,2234,62378,Q1
2022,1,CHACO,32391,64546,36662,8164,2356,144119,Q1
2022,1,CHUBUT,44133,66667,9184,30592,21052,171628,Q1
2022,1,CÓRDOBA,195610,501799,235838,60843,9713,1003803,Q1
2022,1,CORRIENTES,40462,79093,10875,6774,5374,142578,Q1
2022,1,ENTRE RÍOS,67159,138986,23091,26098,12592,267926,Q1
2022,1,FORMOSA,16397,15927,5146,16876,202,54548,Q1
2022,1,JUJUY,21307,60616,25949,4662,3975,116509,Q1
2022,1,LA PAMPA,8003,58978,21739,19903,1109,109732,Q1
2022,1,LA RIOJA,9103,59228,9546,6395,31,84303,Q1
2022,1,MENDOZA,49464,74145,123228,26969,1379,275185,Q1
2022,1,MISIONES,39147,91752,25178,7807,7624,171508,Q1
2022,1,NEUQUÉN,28443,73200,24193,23098,745,149679,Q1
2022,1,RÍO NEGRO,38662,45366,38037,16815,18494,157374,Q1
2022,1,SALTA,44714,98667,40994,5950,7190,197515,Q1
2022,1,SAN JUAN,34038,14449,11294,20723,7674,88178,Q1
2022,1,SAN LUIS,7987,11296,31,71809,28721,119844,Q1
2022,1,SANTA CRUZ,10537,23420,10766,3974,405,49102,Q1
2022,1,SANTA FE,213486,444609,146552,45261,20571,870479,Q1
2022,1,SANTIAGO DEL ESTERO,18118,87979,1093,6349,2922,116461,Q1
2022,1,TIERRA DEL FUEGO,13031,38700,416,124,340,52611,Q1
2022,1,TUCUMÁN,92532,62396,86174,3995,487,245584,Q1
2021,4,BUENOS AIRES,426325,2706506,1176024,126887,73415,4509157,Q4
2021,4,CABA,111360,1205128,60005,5679,29947,1412119,Q4
2021,4,CATAMARCA,16385,13858,25100,1512,2235,59090,Q4
2021,4,CHACO,35548,63145,34688,8005,2359,143745,Q4
2021,4,CHUBUT,46361,57412,9655,28041,18839,160308,Q4
2021,4,CÓRDOBA,212011,487489,217214,61277,8779,986770,Q4
2021,4,CORRIENTES,42523,71183,10138,6778,5290,135912,Q4
2021,4,ENTRE RÍOS,70459,133387,23452,25022,12726,265046,Q4
2021,4,FORMOSA,17211,15111,5151,16018,172,53663,Q4
2021,4,JUJUY,22330,60511,24156,2927,3991,113915,Q4
2021,4,LA PAMPA,8175,58000,20192,19286,1354,107007,Q4
2021,4,LA RIOJA,10387,56651,9446,6613,31,83128,Q4
2021,4,MENDOZA,59842,71553,109667,24666,1859,267587,Q4
2021,4,MISIONES,41778,92068,22035,7649,7602,171132,Q4
2021,4,NEUQUÉN,29175,72761,23253,21531,746,147466,Q4
2021,4,RÍO NEGRO,42037,44495,32212,16558,18451,153753,Q4
2021,4,SALTA,46972,99808,39555,5882,7188,199405,Q4
2021,4,SAN JUAN,35868,13102,11072,11423,8493,79958,Q4
2021,4,SAN LUIS,8472,11064,30,70560,28723,118849,Q4
2021,4,SANTA CRUZ,10790,22902,10031,4346,417,48486,Q4
2021,4,SANTA FE,233427,444373,128856,43556,16229,866441,Q4
2021,4,SANTIAGO DEL ESTERO,19032,86563,1088,6256,2922,115861,Q4
2021,4,TIERRA DEL FUEGO,13317,38148,426,124,342,52357,Q4
2021,4,TUCUMÁN,97830,59022,78790,2511,486,238639,Q4
2021,3,BUENOS AIRES,585729,2595485,885613,120228,64554,4251609,Q3
2021,3,CABA,142902,1192107,42966,6059,29371,1413405,Q3
2021,3,CATAMARCA,18413,11709,22331,1568,2233,56254,Q3
2021,3,CHACO,38258,63659,27583,8018,2353,139871,Q3
2021,3,CHUBUT,49269,55794,8946,23376,18681,156066,Q3
2021,3,CÓRDOBA,229275,477223,167495,57617,15178,946788,Q3
2021,3,CORRIENTES,44805,69403,7542,6766,5303,133819,Q3
2021,3,ENTRE RÍOS,74443,128752,20485,23500,13195,260375,Q3
2021,3,FORMOSA,18093,14111,4730,15690,171,52795,Q3
2021,3,JUJUY,23554,60758,19926,2952,3968,111158,Q3
2021,3,LA PAMPA,9015,57881,17817,14479,1295,100487,Q3
2021,3,LA RIOJA,11329,54744,9444,6613,30,82160,Q3
2021,3,MENDOZA,91474,71247,70579,21811,828,255939,Q3
2021,3,MISIONES,43230,89469,10969,7198,7662,158528,Q3
2021,3,NEUQUÉN,29650,73794,16455,19270,640,139809,Q3
2021,3,RÍO NEGRO,47934,44519,18725,15031,18376,144585,Q3
2021,3,SALTA,49212,98318,36126,5724,6453,195833,Q3
2021,3,SAN JUAN,40072,12922,6670,11372,8447,79483,Q3
2021,3,SAN LUIS,8417,11884,27,68856,28680,117864,Q3
2021,3,SANTA CRUZ,12347,22961,6328,4269,3071,48976,Q3
2021,3,SANTA FE,245929,443156,93412,43447,15640,841584,Q3
2021,3,SANTIAGO DEL ESTERO,19939,85535,909,6147,2928,115458,Q3
2021,3,TIERRA DEL FUEGO,12853,36958,6,16,390,50223,Q3
2021,3,TUCUMÁN,104489,53868,70964,2408,743,232472,Q3
2021,2,BUENOS AIRES,603255,2503830,854173,113546,57547,4132351,Q2
2021,2,CABA,148989,1175097,41318,5580,29371,1400355,Q2
2021,2,CATAMARCA,20305,9426,22331,1449,2233,55744,Q2
2021,2,CHACO,39826,62948,27584,8018,2353,140729,Q2
2021,2,CHUBUT,49271,41497,6081,23682,18706,139237,Q2
2021,2,CÓRDOBA,239780,467782,151855,55944,15519,930880,Q2
2021,2,CORRIENTES,46648,67262,3731,6557,5303,129501,Q2
2021,2,ENTRE RÍOS,77836,124957,17856,23786,13197,257632,Q2
2021,2,FORMOSA,19571,12509,3610,15690,171,51551,Q2
2021,2,JUJUY,24738,60800,19611,2731,3968,111848,Q2
2021,2,LA PAMPA,9017,57014,17132,13209,1295,97667,Q2
2021,2,LA RIOJA,11627,54255,9445,6245,30,81602,Q2
2021,2,MENDOZA,91503,70834,44696,21811,827,229671,Q2
2021,2,MISIONES,44960,87861,10376,5317,7662,156176,Q2
2021,2,NEUQUÉN,30083,72690,15619,19218,640,138250,Q2
2021,2,RÍO NEGRO,48189,43761,18727,15031,18376,144084,Q2
2021,2,SALTA,51396,96016,32050,5724,6453,191639,Q2
2021,2,SAN JUAN,40072,12369,6673,11372,8447,78933,Q2
2021,2,SAN LUIS,8417,11308,28,66860,36205,122818,Q2
2021,2,SANTA CRUZ,12347,22967,6328,4269,3071,48982,Q2
2021,2,SANTA FE,256741,431915,90424,43997,17523,840600,Q2
2021,2,SANTIAGO DEL ESTERO,20734,83770,909,5081,3596,114090,Q2
2021,2,TIERRA DEL FUEGO,12853,22504,6,14,316,35693,Q2
2021,2,TUCUMÁN,110429,48359,71683,1837,743,233051,Q2
2021,1,BUENOS AIRES,629679,2452056,821597,98806,57864,4060002,Q1
2021,1,CABA,159805,1145093,39980,5559,29236,1379673,Q1
2021,1,CATAMARCA,26316,4409,18688,322,2233,51968,Q1
2021,1,CHACO,43214,61251,25426,8004,1875,139770,Q1
2021,1,CHUBUT,45501,40960,3444,23723,18712,132340,Q1
2021,1,CÓRDOBA,260350,444695,134634,54137,17065,910881,Q1
2021,1,CORRIENTES,49160,62876,3337,5949,5303,126625,Q1
2021,1,ENTRE RÍOS,83688,118424,16846,20836,12169,251963,Q1
2021,1,FORMOSA,20663,11412,2562,15669,380,50686,Q1
2021,1,JUJUY,32254,54324,17322,2677,3879,110456,Q1
2021,1,LA PAMPA,8946,58711,15779,12369,1300,97105,Q1
2021,1,LA RIOJA,17363,34984,1,250,30,52628,Q1
2021,1,MENDOZA,91844,69295,38619,18332,833,218923,Q1
2021,1,MISIONES,48292,82339,7064,4796,6896,149387,Q1
2021,1,NEUQUÉN,30223,70457,14171,17752,632,133235,Q1
2021,1,RÍO NEGRO,48777,42192,17828,13994,18377,141168,Q1
2021,1,SALTA,54768,89187,31498,5669,6452,187574,Q1
2021,1,SAN JUAN,40072,11589,6671,11482,8453,78267,Q1
2021,1,SAN LUIS,8417,10678,28,63826,36205,119154,Q1
2021,1,SANTA CRUZ,12347,23089,5975,4264,390,46065,Q1
2021,1,SANTA FE,277012,421480,70976,39140,17519,826127,Q1
2021,1,SANTIAGO DEL ESTERO,26468,75849,570,5158,3596,111641,Q1
2021,1,TIERRA DEL FUEGO,12853,27247,6,0,316,40422,Q1
2021,1,TUCUMÁN,147199,12185,69954,1834,740,231912,Q1
2020,4,BUENOS AIRES,635651,2441248,804991,93444,57927,4033261,Q4
2020,4,CABA,163060,1142528,39890,4815,29237,1379530,Q4
2020,4,CATAMARCA,26870,5115,17856,322,2233,52396,Q4
2020,4,CHACO,44332,61200,23687,7997,1875,139091,Q4
2020,4,CHUBUT,45703,39756,3040,23363,18712,130574,Q4
2020,4,CÓRDOBA,267396,439322,125620,52827,17536,902701,Q4
2020,4,CORRIENTES,50102,61495,3146,5626,5290,125659,Q4
2020,4,ENTRE RÍOS,85683,113670,15653,20206,12169,247381,Q4
2020,4,FORMOSA,21264,10789,2432,15341,380,50206,Q4
2020,4,JUJUY,32850,52815,15639,1077,3470,105851,Q4
2020,4,LA PAMPA,9009,58945,15432,12194,1315,96895,Q4
2020,4,LA RIOJA,17513,34984,1,250,30,52778,Q4
2020,4,MENDOZA,91842,68364,36083,18331,833,215453,Q4
2020,4,MISIONES,49462,79855,6589,4359,6896,147161,Q4
2020,4,NEUQUÉN,30468,70614,13732,17689,632,133135,Q4
2020,4,RÍO NEGRO,48991,42022,17826,13994,18377,141210,Q4
2020,4,SALTA,56659,87817,30604,5858,6452,187390,Q4
2020,4,SAN JUAN,40072,7004,6599,10468,8453,72596,Q4
2020,4,SAN LUIS,8417,11767,27,63019,36205,119435,Q4
2020,4,SANTA CRUZ,12347,19657,1041,4659,2970,40674,Q4
2020,4,SANTA FE,287271,414746,62692,38712,17392,820813,Q4
2020,4,SANTIAGO DEL ESTERO,26812,70522,570,5169,3596,106669,Q4
2020,4,TIERRA DEL FUEGO,12853,26439,6,0,316,39614,Q4
2020,4,TUCUMÁN,149322,11150,68043,1834,740,231089,Q4
2020,3,BUENOS AIRES,653930,2384557,749087,94162,55541,3937277,Q3
2020,3,CABA,170375,1129573,39417,3936,29374,1372675,Q3
2020,3,CATAMARCA,26868,3690,16857,261,2228,49904,Q3
2020,3,CHACO,45745,58825,20675,6706,2003,133954,Q3
2020,3,CHUBUT,45761,39386,2897,23216,18767,130027,Q3
2020,3,CÓRDOBA,276360,430771,102217,48368,9756,867472,Q3
2020,3,CORRIENTES,50858,58681,2960,5513,5379,123391,Q3
2020,3,ENTRE RÍOS,87892,106950,13954,20379,12320,241495,Q3
2020,3,FORMOSA,21790,10003,2000,15023,393,49209,Q3
2020,3,JUJUY,32611,57682,11112,952,4371,106728,Q3
2020,3,LA PAMPA,9015,56845,14677,11893,1305,93735,Q3
2020,3,LA RIOJA,17346,34984,1,250,35,52616,Q3
2020,3,MENDOZA,91908,64672,32817,17523,868,207788,Q3
2020,3,MISIONES,50195,77989,2572,3445,8985,143186,Q3
2020,3,NEUQUÉN,30222,70446,11043,16787,737,129235,Q3
2020,3,RÍO NEGRO,49530,40001,10381,13187,18368,131467,Q3
2020,3,SALTA,58216,84128,25445,5764,7293,180846,Q3
2020,3,SAN JUAN,40092,9223,5509,14023,8480,77327,Q3
2020,3,SAN LUIS,8401,10077,6,61828,36253,116565,Q3
2020,3,SANTA CRUZ,12845,16098,1027,6938,2373,39281,Q3
2020,3,SANTA FE,295051,405807,45721,37112,19307,802998,Q3
2020,3,SANTIAGO DEL ESTERO,26419,70720,555,4185,3613,105492,Q3
2020,3,TIERRA DEL FUEGO,12854,26491,0,0,310,39655,Q3
2020,3,TUCUMÁN,149605,11752,59949,1808,762,223876,Q3
2020,2,BUENOS AIRES,661272,2244277,723072,91736,57189,3777546,Q2
2020,2,CABA,178896,1106133,39482,3937,29373,1357821,Q2
2020,2,CATAMARCA,26968,3641,14878,261,2228,47976,Q2
2020,2,CHACO,46816,56017,17266,6452,1581,128132,Q2
2020,2,CHUBUT,45761,38279,1324,17678,5614,108656,Q2
2020,2,CÓRDOBA,282858,415007,85818,44522,8263,836468,Q2
2020,2,CORRIENTES,51248,55536,3144,3927,5011,118866,Q2
2020,2,ENTRE RÍOS,89391,99423,13954,20042,11303,234113,Q2
2020,2,FORMOSA,21805,9353,1882,14723,169,47932,Q2
2020,2,JUJUY,32705,38938,5057,952,16664,94316,Q2
2020,2,LA PAMPA,8551,54422,14232,11314,1290,89809,Q2
2020,2,LA RIOJA,16885,34984,1,250,35,52155,Q2
2020,2,MENDOZA,91904,62941,29613,15924,802,201184,Q2
2020,2,MISIONES,50792,74497,2579,3319,9153,140340,Q2
2020,2,NEUQUÉN,30256,67990,11037,15755,1134,126172,Q2
2020,2,RÍO NEGRO,49756,39650,10382,11331,18367,129486,Q2
2020,2,SALTA,59502,81740,24289,5123,7108,177762,Q2
2020,2,SAN JUAN,40092,8275,5509,7019,8882,69777,Q2
2020,2,SAN LUIS,8401,8357,6,60935,36253,113952,Q2
2020,2,SANTA CRUZ,12845,16044,1027,6585,2368,38869,Q2
2020,2,SANTA FE,299974,381679,46698,30487,19094,777932,Q2
2020,2,SANTIAGO DEL ESTERO,25917,72074,355,3038,4063,105447,Q2
2020,2,TIERRA DEL FUEGO,12854,26025,0,0,310,39189,Q2
2020,2,TUCUMÁN,150084,9833,55120,1357,762,217156,Q2
2020,1,BUENOS AIRES,673237,2210349,720688,85443,18334,3708051,Q1
2020,1,CABA,184494,1097635,38898,3911,28556,1353494,Q1
2020,1,CATAMARCA,21945,3146,12056,261,2227,39635,Q1
2020,1,CHACO,46356,54144,11958,6239,1580,120277,Q1
2020,1,CHUBUT,45763,27287,1324,16885,5479,96738,Q1
2020,1,CÓRDOBA,286168,406109,68512,41617,8693,811099,Q1
2020,1,CORRIENTES,51126,53231,2172,2437,5004,113970,Q1
2020,1,ENTRE RÍOS,90368,95434,13245,18737,14062,231846,Q1
2020,1,FORMOSA,21068,8887,1800,14510,169,46434,Q1
2020,1,JUJUY,32066,38938,3078,942,16641,91665,Q1
2020,1,LA PAMPA,8553,53755,13821,11295,1802,89226,Q1
2020,1,LA RIOJA,13076,34984,0,251,29,48340,Q1
2020,1,MENDOZA,91955,50251,28059,12465,722,183452,Q1
2020,1,MISIONES,51458,69452,1220,460,10962,133552,Q1
2020,1,NEUQUÉN,29305,65951,11031,14711,729,121727,Q1
2020,1,RÍO NEGRO,47756,38479,10381,11222,18362,126200,Q1
2020,1,SALTA,60426,75593,23025,4125,7212,170381,Q1
2020,1,SAN JUAN,40092,6448,5508,7082,5101,64231,Q1
2020,1,SAN LUIS,8301,7612,5,58301,36333,110552,Q1
2020,1,SANTA CRUZ,12845,15766,1026,6817,2368,38822,Q1
2020,1,SANTA FE,302366,383673,35123,30488,19468,771118,Q1
2020,1,SANTIAGO DEL ESTERO,24695,70424,200,2779,4657,102755,Q1
2020,1,TIERRA DEL FUEGO,12854,25632,0,0,308,38794,Q1
2020,1,TUCUMÁN,143184,10494,44687,1355,347,200067,Q1
2019,4,BUENOS AIRES,720011,2191672,669194,87111,18266,3686254,Q4
2019,4,CABA,196938,1093143,35534,3914,28576,1358105,Q4
2019,4,CATAMARCA,22999,3318,9506,261,2227,38311,Q4
2019,4,CHACO,48661,53602,8831,5229,1580,117903,Q4
2019,4,CHUBUT,47045,26977,1324,15267,5489,96102,Q4
2019,4,CÓRDOBA,296872,410038,53335,37750,8693,806688,Q4
2019,4,CORRIENTES,52525,51845,2002,2458,5004,113834,Q4
2019,4,ENTRE RÍOS,92981,99206,12875,18561,15407,239030,Q4
2019,4,FORMOSA,21567,8684,1760,14531,169,46711,Q4
2019,4,JUJUY,32949,37604,873,814,16641,88881,Q4
2019,4,LA PAMPA,15457,56854,4942,11341,1805,90399,Q4
2019,4,LA RIOJA,13738,34984,0,251,29,49002,Q4
2019,4,MENDOZA,96678,49711,24989,13672,730,185780,Q4
2019,4,MISIONES,53116,69676,847,441,11733,135813,Q4
2019,4,NEUQUÉN,29826,60970,10549,14246,854,116445,Q4
2019,4,RÍO NEGRO,49747,37933,9658,11437,18365,127140,Q4
2019,4,SALTA,63272,76062,21865,3040,8206,172445,Q4
2019,4,SAN JUAN,41360,6338,4931,7241,5104,64974,Q4
2019,4,SAN LUIS,8569,8027,6,55266,36333,108201,Q4
2019,4,SANTA CRUZ,13264,15899,1036,6800,2371,39370,Q4
2019,4,SANTA FE,312072,382254,27464,26978,20401,769169,Q4
2019,4,SANTIAGO DEL ESTERO,24682,71239,200,2810,4657,103588,Q4
2019,4,TIERRA DEL FUEGO,13261,26821,0,0,310,40392,Q4
2019,4,TUCUMÁN,146985,11012,39574,725,348,198644,Q4
0,5,BUENOS AIRES,1277249,2144956,425386,85572,27070,3960233,Sin etiqueta
0,5,CABA,300288,1080973,24900,3895,31155,1441211,Sin etiqueta
0,5,CATAMARCA,24349,5543,13,244,2251,32400,Sin etiqueta
0,5,CHACO,50416,49156,8063,5224,1592,114451,Sin etiqueta
0,5,CHUBUT,37298,27090,1917,15149,7551,89005,Sin etiqueta
0,5,CÓRDOBA,307780,399231,30064,37277,8701,783053,Sin etiqueta
0,5,CORRIENTES,53344,50230,1888,2458,4839,112759,Sin etiqueta
0,5,ENTRE RÍOS,94947,96305,12888,18530,15432,238102,Sin etiqueta
0,5,FORMOSA,21777,8359,1476,14292,162,46066,Sin etiqueta
0,5,JUJUY,33110,35742,274,812,16638,86576,Sin etiqueta
0,5,LA PAMPA,19469,52941,4994,11462,1962,90828,Sin etiqueta
0,5,LA RIOJA,14390,34984,11,251,41,49677,Sin etiqueta
0,5,MENDOZA,148640,54312,6865,12975,1545,224337,Sin etiqueta
0,5,MISIONES,54493,65872,829,419,12270,133883,Sin etiqueta
0,5,NEUQUÉN,43347,60484,5560,13512,2518,125421,Sin etiqueta
0,5,RÍO NEGRO,67478,37425,9739,10806,18847,144295,Sin etiqueta
0,5,SALTA,65799,74329,733,1580,9394,151835,Sin etiqueta
0,5,SAN JUAN,51670,7425,1227,7241,5535,73098,Sin etiqueta
0,5,SAN LUIS,13037,10561,350,62286,36466,122700,Sin etiqueta
0,5,SANTA CRUZ,10663,17056,969,6544,2738,37970,Sin etiqueta
0,5,SANTA FE,319396,377171,18690,24269,21408,760934,Sin etiqueta
0,5,SANTIAGO DEL ESTERO,24556,71198,219,2759,34400,133132,Sin etiqueta
0,5,TIERRA DEL FUEGO,19790,26659,651,0,1487,48587,Sin etiqueta
0,5,TUCUMÁN,150918,12089,116,684,324,164131,Sin etiqueta
0,5,BUENOS AIRES,1284658,2079900,382971,75240,32929,3855698,Sin etiqueta
0,5,CABA,309937,1061358,36082,3962,4281,1415620,Sin etiqueta
0,5,CATAMARCA,25682,5543,13,146,2251,33635,Sin etiqueta
0,5,CHACO,50765,47448,4203,4727,1591,108734,Sin etiqueta
0,5,CHUBUT,37313,26338,1917,14443,7545,87556,Sin etiqueta
0,5,CÓRDOBA,314768,388254,23023,33847,15236,775128,Sin etiqueta
0,5,CORRIENTES,53835,47431,1701,2444,6138,111549,Sin etiqueta
0,5,ENTRE RÍOS,97081,91081,12764,17369,17529,235824,Sin etiqueta
0,5,FORMOSA,21916,8686,1382,14292,162,46438,Sin etiqueta
0,5,JUJUY,33022,30742,274,812,21857,86707,Sin etiqueta
0,5,LA PAMPA,19471,52101,4840,10789,3004,90205,Sin etiqueta
0,5,LA RIOJA,15014,34984,11,251,41,50301,Sin etiqueta
0,5,MENDOZA,148673,54027,6865,12748,1544,223857,Sin etiqueta
0,5,MISIONES,55373,64272,543,421,12269,132878,Sin etiqueta
0,5,NEUQUÉN,43420,59021,4983,12792,2737,122953,Sin etiqueta
0,5,RÍO NEGRO,67841,36527,4037,10485,19657,138547,Sin etiqueta
0,5,SALTA,68827,62343,725,1210,9463,142568,Sin etiqueta
0,5,SAN JUAN,51680,7425,1174,2870,6876,70025,Sin etiqueta
0,5,SAN LUIS,11130,10298,347,57242,38368,117385,Sin etiqueta
0,5,SANTA CRUZ,10665,10257,379,6514,2735,30550,Sin etiqueta
0,5,SANTA FE,325420,355140,18236,21980,22708,743484,Sin etiqueta
0,5,SANTIAGO DEL ESTERO,24393,64783,219,2759,34600,126754,Sin etiqueta
0,5,TIERRA DEL FUEGO,19790,25527,651,0,1486,47454,Sin etiqueta
0,5,TUCUMÁN,153121,12089,116,684,321,166331,Sin etiqueta
0,5,BUENOS AIRES,1304507,2020730,336362,64867,20201,3746667,Sin etiqueta
0,5,CABA,328246,1030814,32281,3978,4281,1399600,Sin etiqueta
0,5,CATAMARCA,26912,4443,16,0,2251,33622,Sin etiqueta
0,5,CHACO,53409,43555,1951,3628,1134,103677,Sin etiqueta
0,5,CHUBUT,37302,23065,1923,14443,3045,79778,Sin etiqueta
0,5,CÓRDOBA,323272,363959,19902,24615,12367,744115,Sin etiqueta
0,5,CORRIENTES,55842,43444,1615,1528,58,102487,Sin etiqueta
0,5,ENTRE RÍOS,100999,90253,12723,16231,12241,232447,Sin etiqueta
0,5,FORMOSA,22570,7878,940,13761,62,45211,Sin etiqueta
0,5,JUJUY,33248,12484,153,640,43622,90147,Sin etiqueta
0,5,LA PAMPA,18832,57373,2891,9023,1041,89160,Sin etiqueta
0,5,LA RIOJA,16367,34984,12,252,41,51656,Sin etiqueta
0,5,MENDOZA,148524,40205,5662,10363,1544,206298,Sin etiqueta
0,5,MISIONES,54898,59214,465,426,7717,122720,Sin etiqueta
0,5,NEUQUÉN,40747,55634,3114,12510,2372,114377,Sin etiqueta
0,5,RÍO NEGRO,68377,34124,3994,9736,4857,121088,Sin etiqueta
0,5,SALTA,74426,57933,647,1135,1879,136020,Sin etiqueta
0,5,SAN JUAN,51660,5838,808,2932,1207,62445,Sin etiqueta
0,5,SAN LUIS,11108,7784,378,53097,23968,96335,Sin etiqueta
0,5,SANTA CRUZ,10659,4615,382,6514,2735,24905,Sin etiqueta
0,5,SANTA FE,340038,340344,15621,23215,17860,737078,Sin etiqueta
0,5,SANTIAGO DEL ESTERO,25337,61547,23,2847,99,89853,Sin etiqueta
0,5,TIERRA DEL FUEGO,19789,23549,1623,0,1486,46447,Sin etiqueta
0,5,TUCUMÁN,159215,11670,118,678,321,172002,Sin etiqueta
2018,4,BUENOS AIRES,1305576,1949637,296102,65477,19814,3636606,Q4
2018,4,CABA,328253,1019490,33042,3978,4257,1389020,Q4
2018,4,CATAMARCA,26912,4443,16,0,2212,33583,Q4
2018,4,CHACO,53409,43555,1940,3236,1130,103270,Q4
2018,4,CHUBUT,37215,23065,952,14443,3047,78722,Q4
2018,4,CÓRDOBA,328854,355716,17675,21851,13243,737339,Q4
2018,4,CORRIENTES,55842,42418,796,1515,30,100601,Q4
2018,4,ENTRE RÍOS,101168,86198,4853,15472,14356,222047,Q4
2018,4,FORMOSA,22619,7880,887,13761,57,45204,Q4
2018,4,JUJUY,33248,12484,153,640,43608,90133,Q4
2018,4,LA PAMPA,18832,55337,2685,7772,1010,85636,Q4
2018,4,LA RIOJA,16367,34984,12,252,36,51651,Q4
2018,4,MENDOZA,148524,40205,5665,10363,1547,206304,Q4
2018,4,MISIONES,55500,53673,465,426,6209,116273,Q4
2018,4,NEUQUÉN,40747,55634,3115,12425,2444,114365,Q4
2018,4,RÍO NEGRO,68377,34292,1299,8037,4832,116837,Q4
2018,4,SALTA,74295,57539,638,253,1853,134578,Q4
2018,4,SAN JUAN,51660,5838,806,2883,1211,62398,Q4
2018,4,SAN LUIS,11108,7784,378,53097,23964,96331,Q4
2018,4,SANTA CRUZ,10659,4615,382,6378,2734,24768,Q4
2018,4,SANTA FE,335519,322782,14387,18705,28997,720390,Q4
2018,4,SANTIAGO DEL ESTERO,25339,61243,23,2649,81,89335,Q4
2018,4,TIERRA DEL FUEGO,19789,23349,1623,0,1499,46260,Q4
2018,4,TUCUMÁN,159215,11670,119,686,314,172004,Q4
2018,3,BUENOS AIRES,1435856,1929273,156382,62318,26448,3610277,Q3
2018,3,CABA,334353,1009252,35694,3872,9319,1392490,Q3
2018,3,CATAMARCA,27553,4443,15,1,2214,34226,Q3
2018,3,CHACO,53927,42359,1990,2628,1129,102033,Q3
2018,3,CHUBUT,58887,23065,1239,13817,6728,103736,Q3
2018,3,CÓRDOBA,337620,342401,15785,19213,10839,725858,Q3
2018,3,CORRIENTES,56444,41300,212,1468,32,99456,Q3
2018,3,ENTRE RÍOS,103318,83714,2403,15093,80,204608,Q3
2018,3,FORMOSA,22777,7589,817,13625,57,44865,Q3
2018,3,JUJUY,33363,10856,32,641,43,44935,Q3
2018,3,LA PAMPA,12415,54574,8437,7011,987,83424,Q3
2018,3,LA RIOJA,16587,34984,13,253,35,51872,Q3
2018,3,MENDOZA,151033,40205,5744,8195,1852,207029,Q3
2018,3,MISIONES,56290,50793,512,391,56,108042,Q3
2018,3,NEUQUÉN,46602,54129,998,12277,2712,116718,Q3
2018,3,RÍO NEGRO,68590,33474,1252,5051,5125,113492,Q3
2018,3,SALTA,76600,53980,678,234,1391,132883,Q3
2018,3,SAN JUAN,54025,5838,826,2744,1048,64481,Q3
2018,3,SAN LUIS,11096,7784,368,52859,2314,74421,Q3
2018,3,SANTA CRUZ,18606,4574,585,6238,3996,33999,Q3
2018,3,SANTA FE,339126,312866,11749,16337,15022,695100,Q3
2018,3,SANTIAGO DEL ESTERO,25805,58789,23,1662,81,86360,Q3
2018,3,TIERRA DEL FUEGO,19365,22649,1502,1,2047,45564,Q3
2018,3,TUCUMÁN,161209,9280,110,252,315,171166,Q3
2018,2,BUENOS AIRES,1450203,1807868,143626,71256,27746,3500699,Q2
2018,2,CABA,342431,977916,35610,3908,9321,1369186,Q2
2018,2,CATAMARCA,27444,4415,15,1,2214,34089,Q2
2018,2,CHACO,54134,40750,562,1946,1129,98521,Q2
2018,2,CHUBUT,58935,19591,1239,14070,6729,100564,Q2
2018,2,CÓRDOBA,345141,327636,13832,16355,10109,713073,Q2
2018,2,CORRIENTES,56541,39715,201,1468,32,97957,Q2
2018,2,ENTRE RÍOS,104811,80376,2405,12313,80,199985,Q2
2018,2,FORMOSA,23543,7311,18,13625,57,44554,Q2
2018,2,JUJUY,33571,10856,23,640,43,45133,Q2
2018,2,LA PAMPA,12416,53587,8420,7011,987,82421,Q2
2018,2,LA RIOJA,16663,34984,13,253,35,51948,Q2
2018,2,MENDOZA,152938,36872,3084,6206,1852,200952,Q2
2018,2,MISIONES,57265,47923,512,391,56,106147,Q2
2018,2,NEUQUÉN,46633,52855,998,12649,2713,115848,Q2
2018,2,RÍO NEGRO,68667,32795,1252,4396,5125,112235,Q2
2018,2,SALTA,78386,53478,678,234,1391,134167,Q2
2018,2,SAN JUAN,54080,5068,826,3079,1048,64101,Q2
2018,2,SAN LUIS,11104,7666,368,16,2314,21468,Q2
2018,2,SANTA CRUZ,18615,4474,585,6734,3997,34405,Q2
2018,2,SANTA FE,337934,304349,11354,15801,15114,684552,Q2
2018,2,SANTIAGO DEL ESTERO,26074,55935,23,1662,81,83775,Q2
2018,2,TIERRA DEL FUEGO,19372,22756,531,1,2047,44707,Q2
2018,2,TUCUMÁN,160315,8965,110,252,315,169957,Q2
2018,1,BUENOS AIRES,1452061,1793884,133928,64379,31194,3475446,Q1
2018,1,CABA,349995,968483,35535,3164,9393,1366570,Q1
2018,1,CATAMARCA,27300,4415,15,1,2214,33945,Q1
2018,1,CHACO,54879,40157,383,388,1130,96937,Q1
2018,1,CHUBUT,56375,19591,1194,14070,6729,97959,Q1
2018,1,CÓRDOBA,349342,326894,13178,13237,11275,713926,Q1
2018,1,CORRIENTES,56937,35225,888,1334,33,94417,Q1
2018,1,ENTRE RÍOS,106998,75751,3789,10776,80,197394,Q1
2018,1,FORMOSA,23556,7095,17,1603,57,32328,Q1
2018,1,JUJUY,33856,10456,23,28,43,44406,Q1
2018,1,LA PAMPA,10807,51389,8386,10556,1926,83064,Q1
2018,1,LA RIOJA,16960,34984,13,253,35,52245,Q1
2018,1,MENDOZA,152931,36872,3086,6206,1852,200947,Q1
2018,1,MISIONES,56311,46880,328,5,56,103580,Q1
2018,1,NEUQUÉN,46714,55072,1000,12404,2713,117903,Q1
2018,1,RÍO NEGRO,68769,31712,1251,4259,5128,111119,Q1
2018,1,SALTA,79936,51534,118,204,1391,133183,Q1
2018,1,SAN JUAN,54080,5068,826,2246,1048,63268,Q1
2018,1,SAN LUIS,11104,7594,368,16,2314,21396,Q1
2018,1,SANTA CRUZ,18615,4474,1799,6734,2783,34405,Q1
2018,1,SANTA FE,341997,300421,10674,11636,15298,680026,Q1
2018,1,SANTIAGO DEL ESTERO,26788,54594,23,1432,81,82918,Q1
2018,1,TIERRA DEL FUEGO,19372,9663,531,1,2047,31614,Q1
2018,1,TUCUMÁN,158611,8921,107,368,50,168057,Q1
2017,4,BUENOS AIRES,1241172,1718013,131181,60082,31448,3181896,Q4
2017,4,CABA,571363,961688,36277,3119,9877,1582324,Q4
2017,4,CATAMARCA,27083,263,11,1,2200,29558,Q4
2017,4,CHACO,55035,39690,389,380,1121,96615,Q4
2017,4,CHUBUT,56378,15097,1187,14070,6708,93440,Q4
2017,4,CÓRDOBA,349710,324709,12778,12043,10739,709979,Q4
2017,4,CORRIENTES,56786,34722,894,1334,35,93771,Q4
2017,4,ENTRE RÍOS,107764,73692,1894,10267,86,193703,Q4
2017,4,FORMOSA,23410,6973,19,1603,51,32056,Q4
2017,4,JUJUY,33844,9626,20,28,34,43552,Q4
2017,4,LA PAMPA,10808,50495,8272,10569,1927,82071,Q4
2017,4,LA RIOJA,16912,34984,14,253,31,52194,Q4
2017,4,MENDOZA,152896,16114,3015,6206,1920,180151,Q4
2017,4,MISIONES,56271,47470,95,5,54,103895,Q4
2017,4,NEUQUÉN,46739,54119,1017,12404,2692,116971,Q4
2017,4,RÍO NEGRO,68690,30451,1250,4259,5114,109764,Q4
2017,4,SALTA,80705,50446,127,158,1376,132812,Q4
2017,4,SAN JUAN,54079,451,812,2246,1036,58624,Q4
2017,4,SAN LUIS,11104,1119,335,17,2329,14904,Q4
2017,4,SANTA CRUZ,18614,1668,582,4638,3950,29452,Q4
2017,4,SANTA FE,341680,293831,10602,10965,15382,672460,Q4
2017,4,SANTIAGO DEL ESTERO,27313,40407,19,1025,80,68844,Q4
2017,4,TIERRA DEL FUEGO,19372,6906,530,1,2045,28854,Q4
2017,4,TUCUMÁN,156583,5223,105,102,319,162332,Q4
2017,3,BUENOS AIRES,1288025,1571180,124920,35058,38777,3057960,Q3
2017,3,CABA,583249,941092,33481,2814,9723,1570359,Q3
2017,3,CATAMARCA,26873,4411,12,1,2181,33478,Q3
2017,3,CHACO,54888,37307,456,36,1072,93759,Q3
2017,3,CHUBUT,56359,5645,1217,13503,6820,83544,Q3
2017,3,CÓRDOBA,344580,319360,10579,7137,14988,696644,Q3
2017,3,CORRIENTES,56247,33993,947,1334,27,92548,Q3
2017,3,ENTRE RÍOS,107774,69596,1786,6245,63,185464,Q3
2017,3,FORMOSA,22647,6816,428,2202,12,32105,Q3
2017,3,JUJUY,33796,9395,20,23,8,43242,Q3
2017,3,LA PAMPA,11378,49679,5153,11536,1944,79690,Q3
2017,3,LA RIOJA,16638,34984,14,252,25,51913,Q3
2017,3,MENDOZA,154036,33788,2772,29,1866,192491,Q3
2017,3,MISIONES,56472,43880,110,5,9,100476,Q3
2017,3,NEUQUÉN,48001,52468,1044,11576,2695,115784,Q3
2017,3,RÍO NEGRO,69301,30018,1106,3054,4017,107496,Q3
2017,3,SALTA,80782,50284,127,158,1167,132518,Q3
2017,3,SAN JUAN,54499,5068,816,1053,1013,62449,Q3
2017,3,SAN LUIS,11407,7576,347,26,2363,21719,Q3
2017,3,SANTA CRUZ,19220,5487,1544,4552,2887,33690,Q3
2017,3,SANTA FE,322953,290655,6338,4897,37499,662342,Q3
2017,3,SANTIAGO DEL ESTERO,27733,54096,19,911,35,82794,Q3
2017,3,TIERRA DEL FUEGO,21587,7012,622,1,2244,31466,Q3
2017,3,TUCUMÁN,154130,6431,106,40,305,161012,Q3
2017,2,BUENOS AIRES,1378549,1535037,119132,21555,24358,3078631,Q2
2017,2,CABA,615262,932466,38628,2819,11016,1600191,Q2
2017,2,CATAMARCA,26401,255,14,1,34,26705,Q2
2017,2,CHACO,54449,35613,458,52,39,90611,Q2
2017,2,CHUBUT,43994,1067,916,13194,4804,63975,Q2
2017,2,CÓRDOBA,341748,303488,4451,6446,1505,657638,Q2
2017,2,CORRIENTES,55262,33192,258,1354,31,90097,Q2
2017,2,ENTRE RÍOS,108309,67650,254,6448,71,182732,Q2
2017,2,FORMOSA,22493,6410,17,1023,13,29956,Q2
2017,2,JUJUY,33742,8858,22,0,35,42657,Q2
2017,2,LA PAMPA,12754,48310,5194,6253,511,73022,Q2
2017,2,LA RIOJA,16244,0,15,2,28,16289,Q2
2017,2,MENDOZA,153331,13030,2581,27,1784,170753,Q2
2017,2,MISIONES,56752,42925,103,5,9,99794,Q2
2017,2,NEUQUÉN,51794,50283,1133,11545,2678,117433,Q2
2017,2,RÍO NEGRO,67038,29147,961,3213,1260,101619,Q2
2017,2,SALTA,80184,27280,115,158,804,108541,Q2
2017,2,SAN JUAN,48670,451,772,1073,915,51881,Q2
2017,2,SAN LUIS,11432,1120,354,26,375,13307,Q2
2017,2,SANTA CRUZ,15311,2722,1365,4735,2255,26388,Q2
2017,2,SANTA FE,329813,228102,3234,4958,1173,567280,Q2
2017,2,SANTIAGO DEL ESTERO,28337,3900,19,911,29,33196,Q2
2017,2,TIERRA DEL FUEGO,22636,6905,665,1,2350,32557,Q2
2017,2,TUCUMÁN,149013,5223,116,14,45,154411,Q2
2017,1,BUENOS AIRES,1559178,1465817,118839,21200,24342,3189376,Q1
2017,1,CABA,428801,918328,38259,2730,10928,1399046,Q1
2017,1,CATAMARCA,26020,248,14,1,34,26317,Q1
2017,1,CHACO,54430,34277,252,52,39,89050,Q1
2017,1,CHUBUT,43994,999,916,13194,4793,63896,Q1
2017,1,CÓRDOBA,335673,293479,4871,5782,1394,641199,Q1
2017,1,CORRIENTES,54993,31994,236,1354,31,88608,Q1
2017,1,ENTRE RÍOS,108509,65095,230,6448,71,180353,Q1
2017,1,FORMOSA,22438,6215,16,1023,13,29705,Q1
2017,1,JUJUY,33869,9278,22,0,34,43203,Q1
2017,1,LA PAMPA,12754,47195,5194,6253,517,71913,Q1
2017,1,LA RIOJA,16180,0,15,2,28,16225,Q1
2017,1,MENDOZA,153326,13030,2581,27,1769,170733,Q1
2017,1,MISIONES,57363,40142,101,5,8,97619,Q1
2017,1,NEUQUÉN,51771,48109,1124,11665,2670,115339,Q1
2017,1,RÍO NEGRO,67075,28785,954,3213,1261,101288,Q1
2017,1,SALTA,79837,26845,114,158,679,107633,Q1
2017,1,SAN JUAN,48670,451,772,1073,907,51873,Q1
2017,1,SAN LUIS,11432,1120,354,26,375,13307,Q1
2017,1,SANTA CRUZ,15502,2722,1272,4733,2257,26486,Q1
2017,1,SANTA FE,327458,226094,3210,4948,1172,562882,Q1
2017,1,SANTIAGO DEL ESTERO,29616,3900,19,911,29,34475,Q1
2017,1,TIERRA DEL FUEGO,22636,6905,665,1,2350,32557,Q1
2017,1,TUCUMÁN,147373,5223,116,14,45,152771,Q1
2016,4,BUENOS AIRES,1563542,1414676,118747,21394,24342,3142701,Q4
2016,4,CABA,434835,914952,38161,2583,10928,1401459,Q4
2016,4,CATAMARCA,26735,250,14,1,34,27034,Q4
2016,4,CHACO,54974,33534,248,52,39,88847,Q4
2016,4,CHUBUT,43994,955,916,13107,4793,63765,Q4
2016,4,CÓRDOBA,337368,289344,3368,5686,789,636555,Q4
2016,4,CORRIENTES,54981,31497,233,1354,31,88096,Q4
2016,4,ENTRE RÍOS,109359,64141,226,6448,71,180245,Q4
2016,4,FORMOSA,22400,6061,16,1023,13,29513,Q4
2016,4,JUJUY,33838,8731,22,0,34,42625,Q4
2016,4,LA PAMPA,12754,47245,5054,6253,522,71828,Q4
2016,4,LA RIOJA,16270,0,16,2,28,16316,Q4
2016,4,MENDOZA,153320,13030,2579,27,1769,170725,Q4
2016,4,MISIONES,57983,39294,100,5,8,97390,Q4
2016,4,NEUQUÉN,51742,46389,1124,11910,2670,113835,Q4
2016,4,RÍO NEGRO,67057,28474,954,3274,1261,101020,Q4
2016,4,SALTA,79389,26657,110,158,621,106935,Q4
2016,4,SAN JUAN,48670,451,772,1121,907,51921,Q4
2016,4,SAN LUIS,11432,1120,354,26,375,13307,Q4
2016,4,SANTA CRUZ,15607,2722,1055,4823,2257,26464,Q4
2016,4,SANTA FE,326721,225792,3201,4946,1172,561832,Q4
2016,4,SANTIAGO DEL ESTERO,30192,3900,19,911,29,35051,Q4
2016,4,TIERRA DEL FUEGO,22636,6905,665,1,2350,32557,Q4
2016,4,TUCUMÁN,146995,4482,116,14,45,151652,Q4
2016,3,BUENOS AIRES,1574216,1355770,113463,18867,24276,3086592,Q3
2016,3,CABA,447726,905105,36796,2514,10963,1403104,Q3
2016,3,CATAMARCA,26689,248,14,1,18,26970,Q3
2016,3,CHACO,56251,32730,232,2,15,89230,Q3
2016,3,CHUBUT,43987,935,916,13364,4750,63952,Q3
2016,3,CÓRDOBA,348481,285480,2540,5695,395,642591,Q3
2016,3,CORRIENTES,55934,30813,217,1354,22,88340,Q3
2016,3,ENTRE RÍOS,112588,61850,206,6441,64,181149,Q3
2016,3,FORMOSA,21800,5905,9,0,2,27716,Q3
2016,3,JUJUY,34250,8236,22,0,30,42538,Q3
2016,3,LA PAMPA,12751,45952,4910,6236,515,70364,Q3
2016,3,LA RIOJA,16891,0,15,2,22,16930,Q3
2016,3,MENDOZA,153233,13030,2576,28,1757,170624,Q3
2016,3,MISIONES,59776,38130,79,5,7,97997,Q3
2016,3,NEUQUÉN,51752,44739,1093,12402,2617,112603,Q3
2016,3,RÍO NEGRO,67043,28496,942,3293,1252,101026,Q3
2016,3,SALTA,80866,26113,90,157,565,107791,Q3
2016,3,SAN JUAN,48670,451,770,1174,903,51968,Q3
2016,3,SAN LUIS,11432,1113,354,23,371,13293,Q3
2016,3,SANTA CRUZ,15570,2722,817,4978,2170,26257,Q3
2016,3,SANTA FE,334911,223011,3037,4862,1190,567011,Q3
2016,3,SANTIAGO DEL ESTERO,31730,3900,19,3,8,35660,Q3
2016,3,TIERRA DEL FUEGO,22636,6276,665,1,2347,31925,Q3
2016,3,TUCUMÁN,147259,3850,116,53,41,151319,Q3
2016,2,BUENOS AIRES,1579448,1305949,113070,21163,25661,3045291,Q2
2016,2,CABA,450644,892209,36669,2390,12672,1394584,Q2
2016,2,CATAMARCA,26262,245,14,1,34,26556,Q2
2016,2,CHACO,56112,31825,221,52,41,88251,Q2
2016,2,CHUBUT,43977,867,916,13293,4803,63856,Q2
2016,2,CÓRDOBA,348891,277615,1709,5610,1089,634914,Q2
2016,2,CORRIENTES,55511,29845,203,1354,43,86956,Q2
2016,2,ENTRE RÍOS,112809,58768,169,6434,193,178373,Q2
2016,2,FORMOSA,22101,5658,6,1023,14,28802,Q2
2016,2,JUJUY,33758,7374,22,0,35,41189,Q2
2016,2,LA PAMPA,12754,44654,4708,6225,547,68888,Q2
2016,2,LA RIOJA,16691,0,15,2,28,16736,Q2
2016,2,MENDOZA,153321,13030,2576,29,1868,170824,Q2
2016,2,MISIONES,59573,36145,77,5,15,95815,Q2
2016,2,NEUQUÉN,51742,42370,1088,12466,2849,110515,Q2
2016,2,RÍO NEGRO,67031,28100,939,3300,1334,100704,Q2
2016,2,SALTA,79438,24719,85,151,539,104932,Q2
2016,2,SAN JUAN,48670,451,770,1214,908,52013,Q2
2016,2,SAN LUIS,11432,1063,354,30,377,13256,Q2
2016,2,SANTA CRUZ,15453,2722,396,4996,2586,26153,Q2
2016,2,SANTA FE,336244,219088,2981,4744,1417,564474,Q2
2016,2,SANTIAGO DEL ESTERO,32101,3900,19,911,30,36961,Q2
2016,2,TIERRA DEL FUEGO,22636,5707,665,1,2350,31359,Q2
2016,2,TUCUMÁN,145486,2968,116,58,49,148677,Q2
2016,1,BUENOS AIRES,1583560,1200859,111231,21108,25757,2942515,Q1
2016,1,CABA,454425,832126,36332,2284,12729,1337896,Q1
2016,1,CATAMARCA,26096,243,15,1,34,26389,Q1
2016,1,CHACO,56353,29994,211,52,41,86651,Q1
2016,1,CHUBUT,43967,834,916,13280,4803,63800,Q1
2016,1,CÓRDOBA,350884,252346,674,5636,386,609926,Q1
2016,1,CORRIENTES,55454,28491,192,1354,45,85536,Q1
2016,1,ENTRE RÍOS,113101,54948,146,6425,193,174813,Q1
2016,1,FORMOSA,21852,5420,5,1023,14,28314,Q1
2016,1,JUJUY,33481,6751,22,0,35,40289,Q1
2016,1,LA PAMPA,12754,41881,4536,6209,549,65929,Q1
2016,1,LA RIOJA,16645,0,16,2,28,16691,Q1
2016,1,MENDOZA,153299,13030,2576,34,1871,170810,Q1
2016,1,MISIONES,59538,33330,70,5,15,92958,Q1
2016,1,NEUQUÉN,51702,36122,1085,12502,2850,104261,Q1
2016,1,RÍO NEGRO,66894,27312,937,3341,1338,99822,Q1
2016,1,SALTA,78973,22741,73,132,507,102426,Q1
2016,1,SAN JUAN,48670,451,770,1195,908,51994,Q1
2016,1,SAN LUIS,11432,1042,354,27,377,13232,Q1
2016,1,SANTA CRUZ,15654,2723,396,5088,2426,26287,Q1
2016,1,SANTA FE,338052,204816,3014,4686,1428,551996,Q1
2016,1,SANTIAGO DEL ESTERO,32838,3900,19,911,30,37698,Q1
2016,1,TIERRA DEL FUEGO,22636,4834,665,1,2350,30486,Q1
2016,1,TUCUMÁN,144233,2165,116,74,49,146637,Q1
2015,4,BUENOS AIRES,1586343,1223603,103269,20397,25773,2959385,Q4
2015,4,CABA,455427,879950,19818,2273,12758,1370226,Q4
2015,4,CATAMARCA,26180,242,15,1,34,26472,Q4
2015,4,CHACO,56818,29456,186,52,41,86553,Q4
2015,4,CHUBUT,43968,811,916,13521,4803,64019,Q4
2015,4,CÓRDOBA,353530,266062,480,5613,385,626070,Q4
2015,4,CORRIENTES,55681,28178,177,1354,45,85435,Q4
2015,4,ENTRE RÍOS,113983,53411,122,6427,194,174137,Q4
2015,4,FORMOSA,21734,5314,4,1023,14,28089,Q4
2015,4,JUJUY,32934,6933,22,0,35,39924,Q4
2015,4,LA PAMPA,12755,42705,4327,6205,374,66366,Q4
2015,4,LA RIOJA,16886,0,16,2,28,16932,Q4
2015,4,MENDOZA,153293,13030,2572,38,1874,170807,Q4
2015,4,MISIONES,60252,32533,48,5,15,92853,Q4
2015,4,NEUQUÉN,51680,38902,1048,12934,2852,107416,Q4
2015,4,RÍO NEGRO,66851,27221,915,3407,1328,99722,Q4
2015,4,SALTA,78744,22446,47,129,554,101920,Q4
2015,4,SAN JUAN,48670,451,770,1230,908,52029,Q4
2015,4,SAN LUIS,11432,1025,354,30,377,13218,Q4
2015,4,SANTA CRUZ,15614,2723,396,5261,2409,26403,Q4
2015,4,SANTA FE,339843,212911,2885,4596,1437,561672,Q4
2015,4,SANTIAGO DEL ESTERO,33582,4365,19,1139,30,39135,Q4
2015,4,TIERRA DEL FUEGO,22636,4301,665,1,2350,29953,Q4
2015,4,TUCUMÁN,144188,1653,116,88,50,146095,Q4
2015,3,BUENOS AIRES,1585467,1183894,113590,19989,25825,2928765,Q3
2015,3,CABA,454815,871262,30974,2229,12788,1372068,Q3
2015,3,CATAMARCA,25801,242,15,1,34,26093,Q3
2015,3,CHACO,56282,28809,186,52,41,85370,Q3
2015,3,CHUBUT,43964,792,916,13408,4803,63883,Q3
2015,3,CÓRDOBA,351692,264055,1450,5412,389,622998,Q3
2015,3,CORRIENTES,55792,27604,176,1340,47,84959,Q3
2015,3,ENTRE RÍOS,113909,51945,122,6261,197,172434,Q3
2015,3,FORMOSA,21573,5264,2,899,14,27752,Q3
2015,3,JUJUY,32598,6895,22,0,35,39550,Q3
2015,3,LA PAMPA,12755,41886,4078,6195,557,65471,Q3
2015,3,LA RIOJA,16725,0,16,2,28,16771,Q3
2015,3,MENDOZA,153299,13030,2572,42,1880,170823,Q3
2015,3,MISIONES,59921,31635,46,5,15,91622,Q3
2015,3,NEUQUÉN,47102,36620,1045,13051,2798,100616,Q3
2015,3,RÍO NEGRO,66806,27130,917,3415,1346,99614,Q3
2015,3,SALTA,78064,21688,47,129,645,100573,Q3
2015,3,SAN JUAN,48670,451,770,1231,908,52030,Q3
2015,3,SAN LUIS,11432,1025,354,31,377,13219,Q3
2015,3,SANTA CRUZ,15540,2718,396,5226,2391,26271,Q3
2015,3,SANTA FE,337042,209673,4169,4426,1428,556738,Q3
2015,3,SANTIAGO DEL ESTERO,33886,4365,19,1097,30,39397,Q3
2015,3,TIERRA DEL FUEGO,22636,8085,665,1,2350,33737,Q3
2015,3,TUCUMÁN,142925,1135,116,88,50,144314,Q3
2015,2,BUENOS AIRES,1581770,1141052,115660,19268,26040,2883790,Q2
2015,2,CABA,453178,858342,19786,2172,12806,1346284,Q2
2015,2,CATAMARCA,25387,242,15,1,34,25679,Q2
2015,2,CHACO,55767,27809,179,52,41,83848,Q2
2015,2,CHUBUT,43949,762,916,13055,4803,63485,Q2
2015,2,CÓRDOBA,348130,255596,435,5199,386,609746,Q2
2015,2,CORRIENTES,55238,26553,157,1321,47,83316,Q2
2015,2,ENTRE RÍOS,113378,49767,119,6031,197,169492,Q2
2015,2,FORMOSA,21097,5164,2,737,50,27050,Q2
2015,2,JUJUY,32183,5482,22,0,35,37722,Q2
2015,2,LA PAMPA,12756,40825,3719,6190,562,64052,Q2
2015,2,LA RIOJA,16463,0,16,2,28,16509,Q2
2015,2,MENDOZA,153301,13030,2572,38,1882,170823,Q2
2015,2,MISIONES,59179,29283,37,5,15,88519,Q2
2015,2,NEUQUÉN,47078,34183,1044,12781,2799,97885,Q2
2015,2,RÍO NEGRO,66738,26268,916,3457,1348,98727,Q2
2015,2,SALTA,77214,20297,47,129,580,98267,Q2
2015,2,SAN JUAN,48670,451,770,1189,908,51988,Q2
2015,2,SAN LUIS,11432,1025,354,33,377,13221,Q2
2015,2,SANTA CRUZ,15343,2707,396,4917,2400,25763,Q2
2015,2,SANTA FE,333117,204685,2877,4320,1389,546388,Q2
2015,2,SANTIAGO DEL ESTERO,33873,4365,19,1091,30,39378,Q2
2015,2,TIERRA DEL FUEGO,22636,7927,665,1,2350,33579,Q2
2015,2,TUCUMÁN,139944,479,116,88,50,140677,Q2
2015,1,BUENOS AIRES,1583135,1096836,134177,18754,28940,2861842,Q1
2015,1,CABA,454934,841743,19334,1994,14716,1332721,Q1
2015,1,CATAMARCA,25033,241,16,1,41,25332,Q1
2015,1,CHACO,54952,26161,164,27,56,81360,Q1
2015,1,CHUBUT,45645,717,906,12540,5465,65273,Q1
2015,1,CÓRDOBA,343883,247564,415,4645,450,596957,Q1
2015,1,CORRIENTES,54649,25372,129,1319,62,81531,Q1
2015,1,ENTRE RÍOS,112363,47411,108,5943,245,166070,Q1
2015,1,FORMOSA,21022,4951,1,670,56,26700,Q1
2015,1,JUJUY,31505,5048,22,0,36,36611,Q1
2015,1,LA PAMPA,13143,39571,3215,6164,604,62697,Q1
2015,1,LA RIOJA,16282,0,16,2,33,16333,Q1
2015,1,MENDOZA,152433,13030,2542,29,2126,170160,Q1
2015,1,MISIONES,58262,26836,30,5,13,85146,Q1
2015,1,NEUQUÉN,47518,32152,1024,12088,2960,95742,Q1
2015,1,RÍO NEGRO,66274,25217,907,3473,1462,97333,Q1
2015,1,SALTA,76280,19781,47,129,574,96811,Q1
2015,1,SAN JUAN,48441,451,755,1165,1007,51819,Q1
2015,1,SAN LUIS,11414,1025,351,30,412,13232,Q1
2015,1,SANTA CRUZ,16215,2700,392,4772,2562,26641,Q1
2015,1,SANTA FE,328809,199037,2845,4239,1507,536437,Q1
2015,1,SANTIAGO DEL ESTERO,33813,4365,19,1020,35,39252,Q1
2015,1,TIERRA DEL FUEGO,22291,7924,657,1,2583,33456,Q1
2015,1,TUCUMÁN,137857,115,116,88,100,138276,Q1
2014,4,BUENOS AIRES,1575978,1070135,120528,17728,32038,2816407,Q4
2014,4,CABA,455785,840224,17155,1962,15394,1330520,Q4
2014,4,CATAMARCA,25192,241,16,0,44,25493,Q4
2014,4,CHACO,55024,10918,31,0,62,66035,Q4
2014,4,CHUBUT,48539,697,891,12256,6159,68542,Q4
2014,4,CÓRDOBA,345157,240452,419,3918,486,590432,Q4
2014,4,CORRIENTES,54754,9526,40,1315,75,65710,Q4
2014,4,ENTRE RÍOS,112291,23027,57,5178,260,140813,Q4
2014,4,FORMOSA,21245,4896,1,0,65,26207,Q4
2014,4,JUJUY,31349,4583,22,37,11,36002,Q4
2014,4,LA PAMPA,16043,34281,514,5894,648,57380,Q4
2014,4,LA RIOJA,16352,0,17,0,33,16402,Q4
2014,4,MENDOZA,151797,13030,2534,31,2222,169614,Q4
2014,4,MISIONES,58435,18613,16,150,15,77229,Q4
2014,4,NEUQUÉN,47721,31778,1014,11853,3030,95396,Q4
2014,4,RÍO NEGRO,66307,23703,901,3819,1530,96260,Q4
2014,4,SALTA,76026,17289,48,6,578,93947,Q4
2014,4,SAN JUAN,48653,451,740,1202,1073,52119,Q4
2014,4,SAN LUIS,11419,926,355,24,423,13147,Q4
2014,4,SANTA CRUZ,17553,448,388,4395,2929,25713,Q4
2014,4,SANTA FE,335267,183009,3205,6282,1634,529397,Q4
2014,4,SANTIAGO DEL ESTERO,34110,4231,19,920,37,39317,Q4
2014,4,TIERRA DEL FUEGO,21948,3664,655,1,2722,28990,Q4
2014,4,TUCUMÁN,137093,97,116,13,105,137424,Q4
2014,3,BUENOS AIRES,1562533,1110628,124474,20049,31881,2849565,Q3
2014,3,CABA,450155,833402,17886,1995,14387,1317825,Q3
2014,3,CATAMARCA,24380,244,15,0,47,24686,Q3
2014,3,CHACO,53321,10336,29,1,59,63746,Q3
2014,3,CHUBUT,49219,668,882,11853,6515,69137,Q3
2014,3,CÓRDOBA,340212,240334,444,4064,377,585431,Q3
2014,3,CORRIENTES,52957,9184,31,1312,65,63549,Q3
2014,3,ENTRE RÍOS,108907,22440,48,5203,135,136733,Q3
2014,3,FORMOSA,21021,4836,0,0,80,25937,Q3
2014,3,JUJUY,30128,3541,22,37,13,33741,Q3
2014,3,LA PAMPA,16051,33940,538,11219,677,62425,Q3
2014,3,LA RIOJA,15864,0,14,1,37,15916,Q3
2014,3,MENDOZA,150120,13030,2512,40,2222,167924,Q3
2014,3,MISIONES,56933,18373,4,3,14,75327,Q3
2014,3,NEUQUÉN,54458,30964,1000,12858,3087,102367,Q3
2014,3,RÍO NEGRO,65264,26590,888,3533,1505,97780,Q3
2014,3,SALTA,73828,18394,43,109,580,92954,Q3
2014,3,SAN JUAN,48272,451,731,1199,1126,51779,Q3
2014,3,SAN LUIS,11303,925,355,25,438,13046,Q3
2014,3,SANTA CRUZ,17862,492,385,4273,3098,26110,Q3
2014,3,SANTA FE,325577,183630,4407,6540,733,520887,Q3
2014,3,SANTIAGO DEL ESTERO,32820,3900,19,768,41,37548,Q3
2014,3,TIERRA DEL FUEGO,21840,3469,650,1,2832,28792,Q3
2014,3,TUCUMÁN,131739,97,117,13,100,132066,Q3
2014,2,BUENOS AIRES,1568881,1025490,120008,17020,33147,2764546,Q2
2014,2,CABA,447637,828411,17729,1883,14555,1310215,Q2
2014,2,CATAMARCA,24380,243,17,0,43,24683,Q2
2014,2,CHACO,53321,9870,30,0,58,63279,Q2
2014,2,CHUBUT,51070,649,866,10960,6974,70519,Q2
2014,2,CÓRDOBA,337825,234729,351,3673,374,576952,Q2
2014,2,CORRIENTES,52883,8680,31,1309,55,62958,Q2
2014,2,ENTRE RÍOS,108900,21706,49,4795,133,135583,Q2
2014,2,FORMOSA,20894,4628,0,0,78,25600,Q2
2014,2,JUJUY,30128,4161,23,40,9,34361,Q2
2014,2,LA PAMPA,15957,32600,513,5869,689,55628,Q2
2014,2,LA RIOJA,15864,0,14,0,34,15912,Q2
2014,2,MENDOZA,148979,13030,2480,36,2282,166807,Q2
2014,2,MISIONES,56933,17594,4,150,8,74689,Q2
2014,2,NEUQUÉN,47767,29776,997,10765,2983,92288,Q2
2014,2,RÍO NEGRO,64920,24944,876,3657,1560,95957,Q2
2014,2,SALTA,73841,17504,45,7,577,91974,Q2
2014,2,SAN JUAN,48161,451,722,1139,1173,51646,Q2
2014,2,SAN LUIS,11306,925,354,22,448,13055,Q2
2014,2,SANTA CRUZ,18956,448,381,4118,3266,27169,Q2
2014,2,SANTA FE,324101,178495,3085,6041,636,512358,Q2
2014,2,SANTIAGO DEL ESTERO,32820,4231,19,907,34,38011,Q2
2014,2,TIERRA DEL FUEGO,21618,3008,648,1,2934,28209,Q2
2014,2,TUCUMÁN,131740,97,121,13,98,132069,Q2
2014,1,BUENOS AIRES,1567685,1000879,120960,16528,33824,2739876,Q1
2014,1,CABA,445569,820161,17767,1866,14555,1299918,Q1
2014,1,CATAMARCA,24126,46,17,0,43,24232,Q1
2014,1,CHACO,52971,9497,30,0,58,62556,Q1
2014,1,CHUBUT,51066,539,866,10776,6974,70221,Q1
2014,1,CÓRDOBA,336841,225769,347,3585,368,566910,Q1
2014,1,CORRIENTES,52565,8279,31,1306,55,62236,Q1
2014,1,ENTRE RÍOS,107883,21379,49,4887,133,134331,Q1
2014,1,FORMOSA,20774,4548,0,0,100,25422,Q1
2014,1,JUJUY,29765,4030,23,0,9,33827,Q1
2014,1,LA PAMPA,15826,31305,513,5848,701,54193,Q1
2014,1,LA RIOJA,15663,0,14,0,34,15711,Q1
2014,1,MENDOZA,148970,12076,2480,37,2282,165845,Q1
2014,1,MISIONES,56597,17191,4,150,8,73950,Q1
2014,1,NEUQUÉN,47790,28161,997,10381,3051,90380,Q1
2014,1,RÍO NEGRO,64886,24156,876,3576,1572,95066,Q1
2014,1,SALTA,73131,17538,45,8,568,91290,Q1
2014,1,SAN JUAN,48161,434,722,808,1173,51298,Q1
2014,1,SAN LUIS,11306,428,354,21,448,12557,Q1
2014,1,SANTA CRUZ,18927,100,381,4092,3264,26764,Q1
2014,1,SANTA FE,322662,174296,3059,5951,644,506612,Q1
2014,1,SANTIAGO DEL ESTERO,32567,3598,19,915,34,37133,Q1
2014,1,TIERRA DEL FUEGO,21618,2837,648,1,2934,28038,Q1
2014,1,TUCUMÁN,129717,83,121,13,98,130032,Q1
0,0,,0,0,0,0,0,0,Sin etiqueta
0,5,,0,0,0,0,0,0,Sin etiqueta
